1111111111
10000000E1
1PCCCCCCC1
1111111111