1111111111111111111111
1MCMCCCMCCCCCMCCCCMCE1
1MCCMCCCCMCCCCCCCCCMM1
1CCCCCCCMCCCCMCCCCCMC1
1PCCMCCCCCCMCCCMCCCMM1
1111111111111111111111