1111111111111111111111
1E000MC00000000C00M001
101M0C01001M000M101001
10100100101010C0001M01
1P000C0M0C00C00M0000C1
1111111111111111111111